18 19 18 28 26 26 29 19 18 18 19 18 18 19 18 26 26 26 26 26 26 29 19 18 18 19 18 18 19 18 18 19 28 26 26 26 26 29 18 18 19 18 18 19 18 18 19 18 18 19
19 18 18 24 16 16 25 26 26 29 28 26 26 26 27 16 16 16 16 16 16 23 18 18 19 18 18 19 18 18 19 28 27 16 16 16 16 23 18 19 18 18 19 18 18 19 18 18 19 18 
18 18 28 27 16 16 16 16 16 25 27 16 16 16 16 16 16 16 16 16 16 23 18 19 18 18 19 18 18 19 28 27 16 16 16 16 16 25 26 29 18 19 18 18 19 18 18 19 18 18 
18 19 24 16 16 16 16 16 16 16 16 16 16 16 16 16 16 16 16 16 16 25 26 26 26 26 26 26 26 26 27 16 16 1 1 1 1 16 16 25 29 18 18 19 18 18 19 18 18 19 
19 18 24 16 12 10 10 10 10 10 10 10 10 10 10 10 10 10 10 10 10 10 10 13 16 16 16 16 16 16 16 16 16 16 1 16 1 1 16 16 25 29 19 18 18 19 18 18 19 18 
18 18 24 16 8 3 3 3 3 3 3 3 3 3 3 3 3 3 3 3 3 3 3 7 20 21 21 21 21 21 21 21 22 16 1 1 1 1 1 1 16 23 18 18 19 18 18 19 18 18 
18 19 24 16 8 3 3 3 3 3 3 3 3 3 3 3 3 3 3 3 3 3 3 7 23 18 19 18 18 19 18 18 24 16 1 16 1 1 1 1 16 25 26 29 18 18 19 18 18 19 
19 18 24 16 8 3 3 4 5 5 5 5 5 5 5 5 5 5 6 3 4 5 5 15 23 18 18 19 18 18 19 18 24 16 1 1 1 16 1 1 1 16 16 25 26 29 18 18 19 18 
18 18 30 22 8 3 3 7 20 21 21 21 21 21 21 21 21 22 8 3 7 20 21 21 31 19 18 18 19 18 18 19 24 16 1 1 1 1 1 1 1 1 16 16 16 25 29 19 18 18 
18 19 18 24 8 3 3 7 23 19 18 18 19 18 18 19 18 24 8 3 7 23 18 19 18 18 19 18 18 19 18 18 24 16 1 1 16 1 1 16 1 1 1 1 16 16 23 18 18 19 
19 18 18 24 8 3 3 7 23 18 19 18 18 19 18 18 19 24 8 3 7 23 18 18 19 18 18 19 18 18 19 18 24 16 1 1 1 1 1 1 1 1 16 1 1 16 23 18 19 18 
18 18 19 24 8 3 3 7 23 18 18 19 18 18 19 18 18 24 8 3 7 23 19 18 18 19 18 18 19 18 18 19 24 16 1 1 1 1 1 1 16 1 1 1 1 16 25 29 18 18 
18 19 18 24 8 3 3 7 23 19 18 18 19 18 18 19 18 24 8 3 7 23 18 19 18 18 19 18 18 19 18 18 24 16 1 1 1 1 16 1 1 1 1 16 1 1 16 23 18 19 
19 18 28 27 8 3 3 7 25 26 26 26 26 26 29 18 28 27 8 3 7 25 26 26 26 26 26 26 26 26 26 26 27 16 1 16 1 1 1 1 1 1 1 1 1 1 16 23 19 18 
18 18 24 16 8 3 3 9 10 10 10 10 13 16 23 18 24 16 8 3 7 16 16 16 16 16 16 16 16 16 16 16 16 16 1 1 1 1 1 1 1 1 1 1 1 1 16 23 18 18 
18 19 24 16 8 3 3 3 3 3 3 3 7 16 23 19 24 16 8 3 9 10 10 10 13 1 1 1 1 1 1 1 1 1 1 1 16 1 1 1 16 1 1 16 1 1 16 23 18 19 
19 18 24 16 8 3 3 3 3 3 3 3 7 16 23 18 24 16 8 3 3 3 3 3 7 16 1 1 1 1 1 1 1 1 1 1 1 1 1 1 1 1 1 1 1 16 20 31 19 18 
18 18 24 16 8 3 3 3 3 3 3 3 7 16 23 18 24 16 8 3 4 5 6 3 7 1 1 16 1 1 1 1 1 1 1 1 1 12 10 13 1 1 1 1 16 20 31 19 18 18 
18 19 24 16 14 5 5 5 6 3 3 3 7 16 23 19 24 16 8 3 7 16 8 3 7 1 1 1 1 1 16 1 1 1 1 1 12 11 3 9 13 1 1 1 16 23 19 18 18 19 
19 18 24 16 20 21 21 22 8 3 3 3 9 16 23 18 24 16 11 3 7 16 8 3 7 1 1 1 1 1 1 1 1 1 12 10 11 3 3 3 9 10 10 10 13 25 29 18 19 18 
18 18 24 16 23 18 19 24 8 3 3 3 3 38 38 38 38 38 3 3 7 16 8 3 7 1 16 1 16 1 1 1 1 12 11 3 3 3 3 3 3 3 3 3 7 16 23 19 18 18 
18 19 24 16 23 18 18 24 8 3 3 3 3 40 40 40 40 40 3 3 7 16 8 3 7 1 1 1 1 1 1 1 12 11 3 3 3 3 3 3 3 3 3 3 7 16 23 18 18 19 
19 18 24 16 23 19 18 24 8 3 3 3 4 16 23 18 24 16 6 3 7 16 8 3 7 1 1 1 1 16 1 1 8 3 3 3 3 3 3 3 3 3 3 3 7 16 25 29 19 18 
18 18 30 21 31 18 19 24 8 3 3 3 7 16 23 18 24 16 8 3 9 10 11 3 7 1 16 1 1 1 1 1 14 6 3 3 3 3 3 3 3 3 3 3 7 16 16 23 18 18 
18 19 18 18 19 18 18 24 8 3 3 3 7 16 23 19 24 16 8 3 3 3 3 3 7 1 1 1 16 1 1 16 1 14 6 3 3 3 3 3 3 3 3 3 7 1 16 23 18 19 
19 18 28 26 29 19 18 24 8 3 3 3 7 16 23 18 24 16 8 3 3 4 5 5 15 1 1 1 1 1 1 1 1 1 14 5 6 3 3 3 4 5 5 5 15 1 16 23 19 18 
18 18 24 16 23 18 19 24 8 3 3 3 7 16 23 18 24 16 16 41 39 16 16 16 16 16 16 16 16 16 16 16 16 1 1 1 14 6 3 4 15 1 1 1 1 1 16 23 18 18 
18 19 24 16 23 18 18 24 8 3 3 3 7 16 23 19 30 21 21 41 39 21 21 21 21 21 21 21 21 21 21 21 22 1 1 1 1 14 5 15 1 1 1 1 1 1 16 23 18 19 
19 18 24 16 23 19 18 24 8 3 3 3 7 16 23 18 18 19 18 41 39 18 18 19 18 18 19 18 18 19 18 18 24 1 1 1 16 1 1 1 1 1 1 16 16 16 20 31 19 18 
18 18 24 16 25 26 26 27 8 3 3 3 7 16 25 26 26 26 26 41 39 26 26 18 19 18 18 19 18 18 19 18 24 1 1 1 1 1 1 1 1 16 1 16 20 21 31 19 18 18 
18 19 24 16 16 16 16 16 8 3 3 3 7 16 16 16 16 16 16 41 39 16 16 23 18 19 18 18 19 18 18 19 24 1 1 1 1 1 1 1 1 1 1 16 23 18 19 18 18 19 
19 18 24 16 16 12 10 10 11 3 3 3 9 10 10 10 10 10 11 3 3 9 13 23 18 18 19 18 18 19 18 18 24 1 1 16 1 1 1 1 1 1 16 20 31 19 18 18 19 18 
18 18 24 16 16 8 3 3 3 3 3 3 3 3 3 3 3 3 3 3 3 3 7 23 19 18 18 19 18 18 19 18 24 1 1 1 1 1 1 16 1 1 16 23 19 18 18 19 18 18 
18 19 30 22 16 8 3 32 32 5 5 5 32 32 32 32 32 3 3 3 3 3 7 23 18 19 18 18 19 18 18 19 24 1 1 1 1 1 1 1 1 1 16 25 29 18 19 18 18 19 
19 18 18 30 22 8 3 32 32 32 1 32 32 1 1 1 32 3 3 3 3 3 7 23 18 18 19 18 18 19 18 18 24 1 1 1 1 16 1 1 1 1 1 16 23 19 18 18 19 18 
18 18 19 18 24 8 3 32 1 3 3 3 1 1 1 1 32 3 3 3 3 3 7 23 19 18 18 19 18 18 19 18 24 1 1 1 1 1 1 1 1 16 1 16 23 18 18 19 18 18 
18 19 18 18 24 8 3 32 1 3 3 3 1 1 1 1 32 3 3 3 3 3 7 23 18 19 18 18 19 18 18 19 24 1 16 1 1 1 1 1 1 1 1 16 25 26 29 18 18 19 
19 18 18 28 27 8 3 32 1 3 3 3 3 3 3 2 32 3 3 3 3 3 7 23 18 18 19 18 18 19 18 18 24 1 1 1 16 1 1 1 1 1 1 1 1 16 23 18 19 18 
18 18 28 27 16 8 3 32 1 3 3 3 3 3 3 33 32 3 3 3 3 3 7 23 19 18 18 28 26 26 26 26 27 1 1 1 1 1 1 1 16 1 1 1 16 16 25 29 18 18 
18 19 24 16 16 8 3 32 1 3 3 3 3 3 3 2 32 3 3 3 3 3 9 23 18 19 18 24 1 1 16 1 1 1 1 1 1 1 1 1 1 1 1 1 1 1 16 23 18 19 
19 18 24 16 16 8 3 32 1 1 1 1 1 1 1 1 32 3 3 3 3 3 38 38 38 38 38 38 38 1 1 1 1 1 1 16 1 1 1 1 1 1 16 1 1 1 16 23 19 18 
18 18 24 16 16 8 3 32 32 32 32 32 32 32 32 32 32 3 3 3 3 3 40 40 40 40 40 40 40 1 1 1 16 1 1 1 1 1 16 1 1 1 1 1 1 16 16 23 18 18 
18 19 24 16 16 8 3 3 3 3 3 3 3 3 3 3 3 3 3 3 3 3 4 23 18 19 18 24 1 1 1 1 1 1 1 1 1 1 1 1 1 1 1 1 1 16 16 23 18 19 
19 18 30 22 16 8 3 3 3 3 4 16 16 16 6 3 3 3 3 3 3 3 7 23 18 18 19 24 1 1 16 1 1 1 1 1 16 1 1 1 1 1 16 1 16 16 20 31 19 18 
18 18 18 30 22 8 3 3 4 16 16 20 21 22 16 16 6 3 3 3 3 3 7 25 26 26 26 27 1 1 1 16 16 16 16 1 1 1 1 1 16 1 1 1 16 20 31 19 18 18 
18 19 18 18 24 14 5 5 16 20 21 31 18 30 21 22 16 5 5 5 5 5 15 16 16 16 16 16 16 1 16 20 21 21 22 16 1 1 1 1 1 1 1 1 16 25 26 26 29 19 
19 18 18 18 24 16 16 16 20 31 18 18 19 18 18 30 22 16 16 16 16 16 16 16 16 16 16 16 16 16 20 31 18 19 30 22 1 1 1 1 1 1 16 16 16 16 16 16 23 18 
18 18 18 18 30 21 21 21 31 18 18 19 18 18 19 18 30 21 21 21 21 21 21 21 21 21 21 21 21 21 31 18 19 18 18 24 16 1 1 1 16 16 20 21 21 22 16 16 23 18 
18 19 18 18 19 18 18 19 18 18 19 18 18 19 18 18 19 18 18 19 18 18 19 18 18 19 18 18 19 18 18 19 18 18 19 30 22 16 16 16 20 21 31 19 18 30 21 21 31 19 
19 18 18 19 18 18 19 18 18 19 18 18 19 18 18 19 18 18 19 18 18 19 18 18 19 18 18 19 18 18 19 18 18 19 18 18 30 21 21 21 31 18 19 18 18 19 18 18 19 18 
